	
/////
cars = Лекговые автомобили
trucks = Грузовые автомобили
carsMedium = Средние легковые автомобили
motorcycles = Мотоциклы 
buses = Автобусы
\\\\\


carsS = Количество Легковых автомобтлей 
trucksS = Количество Грузовых автомобтлей
carsMediumS = Количество Средних легковых машин
motorcyclesS = Количество Мотоциклов
busesS = Количество Автобусов



carsMPY = Побег Легковых автомобтлей в год
trucksMPY = Пробег Грузовых автомобтлей в год
carsMediumMPY = Пробег Средних легковых машин в год
motorcyclesMPY = Пробег Мотоциклов в год
busesMPY = Пробег Автобусов в год



carsMPM = Пробег Легковых автомобтлей в месяц
trucksMPM = Пробег Грузовых автомобтлей в месяц
carsMediumMPM = Пробег Средних легковых машин в месяц
motorcyclesMPM = Пробег Мотоциклов в месяц
busesMPM = Пробег Автобусов в месяц



carsMPD = Пробег Легковых автомобтлей в день
trucksMPD = Пробег Грузовых автомобтлей в день
carsMediumMPD = Пробег Средних легковых машин в день
motorcyclesMPD = Пробег Мотоциклов в день
busesMPD = Пробег Автобусов в день

carsC1K = Выделяемый CO2 за 1 км езды на Легковом автомобиле
truckC1K = Выделяемый CO2 за 1 км езды на Грузовом автомобиле
carsMediumC1K = Выделяемый CO2 за 1 км езды на Среднем легковом автомобиле
motorcyclesC1K = Выделяемый CO2 за 1 км езды на Мотоцикле
busesC1K = Выделяемый CO2 за 1 км езды на Автобусе

peopleQ = количество людей в РК

cars1CD = Выброс 1 машины за день
cars1CM = Выброс 1 машины за месяц
cars1CY = Выброс 1 машины за год

trucks1CD = Выброс 1 грузовой машины за день
trucks1CM = Выброс 1 грузовой машины за месяц
trucks1CY = Выброс 1 грузовой машины за год

carsMedium1CD = Выброс 1 средней легковой машины за день
carsMedium1CM = Выброс 1 средней легковой машины за месяц
carsMedium1CY = Выброс 1 средней легковой машины за год

motorcycles1CD = Выброс 1 мотоцикла за день
motorcycles1CM = Выброс 1 мотоцикла за месяц
motorcycles1CY = Выброс 1 мотоцикла за год

buses1CD = Выброс 1 автобуса за день
buses1CM = Выброс 1 автобуса за месяц
buses1CY = Выброс 1 автобуса за год

carsAD = Выброс всех легковых машин в РК в день
carsAM = Выброс всех легковых машин в РК в месяц
carsAY = Выброс всех легковых машин в РК в год
trucksAD = Выброс всех грузовых машин в РК в день
trucksAM = Выброс всех грузовых машин в РК в месяц
trucksAY = Выброс всех грузовых машин в РК в год
carsMediumAD = Выброс всех средних легковых машин в РК в день
carsMediumAM = Выброс всех средних легковых машин в РК в месяц
carsMediumAY = Выброс всех средних легковых машин в РК в год
motorcyclesAD = Выброс всех мотоциклов в РК в день
motorcyclesAM = Выброс всех мотоциклов в РК в месяц
motorcyclesAY = Выброс всех мотоциклов в РК в год
busesAD = Выброс всех автобусов в РК в день
busesAM = Выброс всех автобусов в РК в месяц
busesAY = Выброс всех автобусов в РК в год

alltsD = Выброс всего транспорта РК в день
alltsM = Выброс всего транспорта РК в месяц 
alltsY = Выброс всего транспорта РК в год

allts1PD = Выделение CO2 на одного жителя РК за день
allts1PM = Выделение CO2 на одного жителя РК за месяц
allts1PY = Выделение CO2 на одного жителя РК за год

